1111111111111111111
1P00000000C00000001
1000000000000000001
1000000000000000001
10000C0C0C0C0000001
10000C0C0C0C0000001
10000C0C0C0C0000001
10000C0C0C0C0000001
10000C0C0P0C0000001
10000C0C0C0C0000001
10000C0C0C0C00000E1
1111111111111111111