1111111111
1P001100E1
1000110001
1000000001
1000000001
1000110001
10C0110C01
1000CC0001
1111111111