111111111111111111111111111111111111111
1000000000000000000000000000000000000E1
100000000000000000000000000000000000001
100000000000000000000000000000000000001
10000000000C000000000000000000000000001
100000000000C00000000000000000000000001
1000000P00000C0000000000000000000000001
111111111111111111111111111111111111111